3
m m m m m m m
m 3 1 7 m p m
m m 3 m 8 1 m
m 2 1 p m u m
m i 3 m m m m
m 2 m 9 m m m
